com.google
0 0
. . . . .
. . s . .
. . . . .
. . . . .
. x . x .
. . . . .