127.0.0.1
0 0
. . . . . . .
. s h p . . .
. . . . . f .
. . . . . . .
. t . x . . .
. . . . . . .