127.0.0.1
0 0
. . . . . . .
. s s . . . .
. . . . . x .
. . . . . . .
. x . x . . .
. . . . . . .